WWWWWWWWWWWWWWWWWWWW
WWWWWWWWWWWWWWWWWWWW
WWWWWWWWWWWWWWWWWWWW
WOOOOOOOOOOOOOOOOOOW
WOOOOOOOOOOOOOOOOOOW
WOOOOOOOOOOOOOOOOOOW
WOOOPOOOOOOOOOOOOOOW
WOOOOOOOOOOOOOOOOOOW
WOOOOOOOOOOOOOOOOOOW
WOOOOOOOOOOOOOOOOOOW
WOOOOOOOOOOOOOOOOOOW
WOOOOOOOWWWOOOOOOOOW
WOOOOOOOOWOOOOOOOOOW
WOOOOOOOOWOOOOOOOOOW
WOOOOOOOWWWOOOOOOOOW
WOOOOOOOBBBOOOOOOOOW
WOOOOOOOOBOOOOOOOOOW
WOOOOOOOOBOOOOOOOOOW
WOOOOOOOOBOOOOOOOOOW
WWWWWWWWWWWWWWWWWWWW